G G G G G G G G G G G G G G G G
T T T T T T T G G G G G G G G G
T T T T T T T T T G G G G G G G
G T T T T T T T G G G G G G G G
C C C C C C C C C C C C C C C P
M M M M M M M M M M M M M M M Q
V V V V V V V V V V V V V V V X
G G G G G G G G G G G G G G G G
G G G G G G G G G G G G G G G G
G G G G G G G G G G G G G G G G
G G G G G G G G G G G G G G G G
G G G G G G G G G G G G G G G G